
R 1280 1024

NO ./textures/wood.xpm
SO ./textures/ickdoor.xpm
WE ./textures/sp_dude.xpm
EA ./textures/colorstone.xpm
S ./textures/barrel.xpm


F 220,100,0
C 225,30,0


11111111111
12010010001
10000000001
10N00000001
10000000001
10000000001
11111111111