
R 100 100

NO ./textures/marbface.xpm
SO ./textures/crackle4.xpm
WE ./textures/sp_dude.xpm
EA ./textures/flat-ligth.xpm
S ./textures/cacodemon.xpm


F 220,100,0
C 225,30,0


11111111111
10010012001
10200000001
10000000001
10N00000001
10200000201
11111111111