
R 1280 1024

NO ./textures/wood.xpm
SO ./textures/ickdoor.xpm
WE ./textures/sp_dude.xpm
EA ./textures/colorstone.xpm
S ./textures/barrel.xpm


F 220,100,0
C 225,30,0


1111111111
1001001001
1000000001
100E000201
1000000001
1000000001
1111111111