R    800 600

          NO ./textures/marbface.xpm


   SO ./textures/crackle4.xpm
    WE ./textures/sp_dude.xpm
 EA ./textures/flat-ligth.xpm
     S   ./textures/cacodemon.xpm


   F    128, 0, 0
C     105, 105, 105


11111111
10000001
10201111
11100001
12000021
100N0001
11111111
