
R 1920 1080
NO ./path_to_the_north_texture
SO ./path_to_the_south_texture
WE ./path_to_the_west_texture
EA ./textures/redbrick.xpm
S ./path_to_the_sprite_texture

F 220,100,0
C 225,30,0


1111111
1010001
1000001
1000001
1000001
10N0001
1111111