
R 1920 1080

NO ./textures/wood.xpm
SO ./textures/ickdoor.xpm
WE ./textures/sp_dude.xpm
EA ./textures/colorstone.xpm
S ./textures/barrel.xpm


F 220,100,0
C 225,30,0


1111111
1001001
1000001
100S001
1000001
1002001
1111111