
R 1920 1080

NO ./path_to_the_north_texture
SO ./path_to_the_south_texture
WE ./path_to_the_west_texture
EA ./textures/redbrick.xpm
S ./path_to_the_sprite_texture


F 220,100,0
C 225,30,0


11111111111111111111111111111111111
10000111111111100000000000000000011
11001011101010201010100011010101101
11110000001111111111100010101010101
11111000000110011111000111111111111
11111111110000011111111111000000001
11111222010011111011111011001111111
11111111110001111111110110011111111
11111111110001111100000000011111111
10000000000000111000100011111111111
11111111100001111111000000000001111
1000E000001111111120000000000000011
11111111111111111111111111111111111