
R 1920 1280

NO ./textures/wood.xpm
SO ./textures/ickdoor.xpm
WE ./textures/sp_dude.xpm
EA ./textures/colorstone.xpm
S ./textures/barrel.xpm


F 220,100,0
C 225,30,0


11111111111
10010010001
10000S00001
10000000001
10000000001
10200000201
11111111111