


R    800 600

          NO ./textures/cacodemon.xpm


   SO ./textures/cacodemon.xpm
    WE ./textures/cacodemon.xpm
 EA ./textures/cacodemon.xpm
     S   ./textures/cacodemon.xpm


   F    0, 0, 12
C     255, 255, 255


111111111111111111111111111111111111111111111111111111111111
111000000000000000000000000000000000011111111111111111111111
11100000000000000000000000000000000001
11100000000000000000000000000000000001
11100000000000000000000000000000000001
11100000000000000000000000000000000001
11100000000000000000000000000000000001
11100000000000000022222222000000000001
11100000000000000000000000000000000001
11100000000000000000000000000000000001
1110000000000000000000000000N000000001
11100000000000000000000000000000000001
11100000000000000000000000000000000001
11100000000000000000000000000000000001
11100000000000000000000000000000000001
11100000000000000000000000000000000001
11100000000000000000000000000000000001
11111111111111111111111111111111111111