R 1920 1080
MO ./path_to_the_north_texture
SO ./path_to_the_south_texture
WE ./path_to_the_west_texture
EA ./path_to_the_east_texture
S ./path_to_the_sprite_texture

F 220,100,0
C 225,30,0

10002000000000001100000010001
10000000000000001101010010001
110001110101011111011110N0111
11110111 1110101 101111010001
11111111 1111111 111111111111