R    1920 1080

          NO ./textures/marbface.xpm


   SO ./textures/crackle4.xpm
    WE ./textures/sp_dude.xpm
 EA ./textures/flat-ligth.xpm
     S   ./textures/cacodemon.xpm


   F    128, 0, 0
C     105, 105, 105


1111
10N1
1021
1111