10002000000000001100000010001
10000000000000001101010010001
11000111010101111101111000111
11110111 1110101 101111010001
11111111 1111111 111111111111