111111
110101
1020011
1100N1
111111