        11111 1111111111111111111
        1000111100110000000000001
        1011110001110000002000001
        1001 100000000000000000011
111111111011110001110000000000001
1000000000110000011101111111111111
11110111111111011100000010001
11110111111111011101010010001
110000001101010111000000100011
10002000000000001100000010001
100000000000000011010100100011
10001111110101011111011110N011111
11111  10011111010N110111100001
  11 11111111111111111111111111