        11111 1111111111111111111
        1000111100110000000000001
        1011110001110000002000001
        1001 100000000000000000011
111111111011110001110000000000001
1000000000110000011101111111111111
11111111111111111111111111111

111111111111111111111111111111
 110000001101010111000000100011
110002000000000011000000100011
1000000000N0000011010100100011
10001111110010101110111100011111
11111  10011110101110111100001
  11 11111111111111111111111111