111111
110101
102001
1100N1
111111