        11111  111111111111111111
        1000111100110000000000001
        1011000001110000002000001
        1001000000000000000000001
111111111011000001110000000000001
100000000011000001110111111111111
11110111111111011100000010001
11110111111111011101010010001
11000000110101011100000010001
10002000000000001100000010001
10000000000000001101010010001
10000001110101011111011110N0111
1111110011111010N11011110100001
  11 111111111111111111111111111