111111
10010111
102001
1100N11
11111