111111
10010111111
102001
1100N1
111111